1111111111
1000000001
1000040001
1000000001
1000000001
1000030001
1000000001
1000000001
1000000001
1111111111